16 30

7 3 1

0 0 0 0 0 0 0 0 0 0 0 0 0 0 0 0 0 0 0 0 0 0 0 0 0 0 0 0 0 0 
0 0 0 0 0 8 8 8 8 0 0 0 0 0 0 0 0 0 0 0 0 0 0 0 0 0 0 0 0 0 
0 0 0 0 0 0 0 0 8 0 0 0 0 0 0 0 0 8 8 8 8 8 8 8 0 0 0 0 0 0 
0 0 0 8 8 8 8 8 8 8 8 8 8 8 0 0 0 8 0 0 0 0 0 8 0 0 0 0 0 0 
0 0 0 8 0 0 0 0 0 0 0 0 0 8 0 0 0 8 0 0 0 0 0 8 8 8 8 8 0 0 
0 0 0 8 0 0 0 0 0 0 0 0 0 8 8 8 8 8 0 0 0 0 0 8 0 0 0 8 0 0 
0 0 0 8 0 0 0 0 0 0 0 0 0 0 0 0 0 0 0 0 0 0 0 8 0 0 0 8 0 0 
0 0 8 8 8 0 0 0 0 0 0 0 0 0 0 0 0 0 0 0 8 8 8 8 0 0 0 8 0 0 
0 0 8 8 8 0 0 0 0 0 0 0 0 0 0 0 0 0 0 0 8 0 0 0 0 8 8 8 0 0 
0 0 8 8 8 0 0 0 0 0 0 0 0 0 0 0 0 0 0 0 8 0 0 0 0 0 0 0 0 0 
0 0 0 8 0 0 0 0 0 0 0 0 0 0 0 0 0 0 0 0 8 0 0 0 0 0 0 0 0 0 
0 0 0 8 0 0 0 0 8 8 8 8 8 8 8 8 0 0 0 0 8 8 8 8 8 8 8 8 0 0 
0 0 0 8 0 0 0 0 8 0 0 8 0 0 0 8 0 0 0 0 0 0 0 0 0 0 0 8 0 0 
0 0 0 8 8 8 8 8 8 0 0 8 0 0 0 8 8 8 8 8 8 8 8 8 8 8 8 8 0 0 
0 0 0 0 0 0 0 0 0 0 0 8 8 8 0 0 0 0 0 0 0 0 0 0 0 0 0 0 0 0 
0 0 0 0 0 0 0 0 0 0 0 0 0 0 0 0 0 0 0 0 0 0 0 0 0 0 0 0 0 0 

